el profesor - nauczyciel
la profesora - nauczycielka
el estudiante - uczeń
la estudiante - uczennica
el libro - książka
la página - strona
el cuaderno - zeszyt
el bolígrafo - długopis
el lápiz - ołówek
la goma - gumka do mazania
la pizarra - tablica
la clase - lekcja
el examen - egzamin
la nota - ocena
el idioma - język
la palabra - słowo
la frase - zdanie
la pregunta - pytanie
la respuesta - odpowiedź
el ejemplo - przykład
la ropa - ubranie
la camisa - koszula
la camiseta - koszulka
el pantalón - spodnie
la falda - spódnica
el vestido - sukienka
los zapatos - buty
las botas - kozaki
los calcetines - skarpetki
la chaqueta - kurtka
el abrigo - płaszcz
el sombrero - kapelusz
la gorra - czapka z daszkiem
el cinturón - pasek
la bufanda - szalik
los guantes - rękawiczki
la tienda - sklep
el mercado - targ
el supermercado - supermarket
la panadería - piekarnia
la carnicería - sklep mięsny
la pescadería - sklep rybny
la frutería - sklep z owocami
la verdulería - sklep z warzywami
la farmacia - apteka
el dinero - pieniądze
el billete - banknot/bilet
la moneda - moneta
el precio - cena
la oferta - oferta
el cliente - klient
la clienta - klientka
el vendedor - sprzedawca
la vendedora - sprzedawczyni
la compra - zakup
la venta - sprzedaż
el regalo - prezent
la caja - kasa/pudełko
la bolsa - torba
el carrito - wózek sklepowy
el desayuno - śniadanie
el almuerzo - obiad/lunch
la cena - kolacja
el plato - talerz/danie
el vaso - szklanka
la taza - filiżanka
el cuchillo - nóż
el tenedor - widelec
la cuchara - łyżka
la servilleta - serwetka
el aceite - olej
la sal - sól
el azúcar - cukier
la pimienta - pieprz
el huevo - jajko
el queso - ser
la carne - mięso
el pescado - ryba
el pollo - kurczak
la sopa - zupa
la ensalada - sałatka
la patata - ziemniak
el tomate - pomidor
la zanahoria - marchewka
la cebolla - cebula
el ajo - czosnek
la fresa - truskawka
la manzana - jabłko
la naranja - pomarańcza
el plátano - banan
la uva - winogrono
la sandía - arbuz
el melón - melon
el limón - cytryna
la bebida - napój
el refresco - napój gazowany
la cerveza - piwo
el vino - wino
el postre - deser
el helado - lody